ib&&&&.a.&&&&&&&
e..&&&Akl&&&&&&&
dyg&&&n...x&&&dt
....wvwbp..&&&..
...f...&&&h&&&j.
&&.pct.&&&.&&&..
&&u&&&j&&&&&&...
&&&&&&q.xk&&&...
&&&&&&..o.&&&..s
&&&.c&&&n&B..r.y
i.&&&&&&m..l.u.s
..&&&&&&&&of...a
.g&&&..&&&e.....
.......&&&&.v...
....q...&&&....h
m.......&&&..r..
